20002000200020002000200020002000200020002000
00000000000000000000000000000000000000000000
00000000000000000000000000000000000000000000
00030000000300000003000000030000000300000000
20000000200000002000000020000000200000002000
00000000000000000000000000000000000000000000
00000000000000000000000000000000000000000000
00000000000000000000000000000000000000000000
20002000200020002000200020002000200020002000
00000000000000000000000000000000000000000000
00000000000000000000000000000000000000000000
00030000000300000003000000030000000300000000
20000000200000002000000020000000200000002000
00000000000000000000000000000000000000000000
00000000000000000000000000000000000000000000
00000000000000000000000000000000000000000000
20002000200020002000200020002000200020002000
00000000000000000000000000000000000000000000
00000000000000000000000000000000000000000000
00030000000300000003000000030000000300000000
20000000200000002000000020000000200000002000
00000000000000000000000000000000000000000000
00000000000000000000000000000000000000000000
00000000000000000000000000000000000000000000
20002000200020002000200020002000200020002000
00000000000000000000000000000000000000000000
00000000000000000000000000000000000000000000
00030000000300000003000000030000000300000000
20000000200000002000000020000000200000002000
00000000000000000000000000000000000000000000
00000000000000000000000000000000000000000000
00000000000000000000000000000000000000000000
20002000200020002000200020002000200020002000
00000000000000000000000000000000000000000000
00000000000000000000000000000000000000000000
00000000000000000000000000000000000000000000
