200020002000
000000000000
000000000000
000300000000
200000002000
000000000000
000000000000
000000000000
200020002000
000000000000
000000000000
000000000000
